11111111111111
100E1110011001
1C0011100P0001
10000C000000C1
11111111111111
