11111111111111
1000000E000001
10000C00000001
100000000P0001
11111111111111
