1111111111111
1ECP000000001
1111111111111
