1111111
11E1111
11C1111
11P1111
1111111
