111111111111111
1ECP11111111111
111111111111111
111111111111111
