11111111111111
110E1110010001
1C0010001P0001
1100000000C0C1
11111111111111
