1111
1E01
1011
1011
1P01
1111
