1111111111111111111111111
1000111100000000000000001
1000000000000000000000001
100000000P000000000000001
1000C00000000000000000001
10000000000E0000000000001
1111111111111111111111111
