111111111111
1E1C1P111111
111111111111
