111111111111111
1000E0000C0C001
100000000000001
111111111111111
