1111111110
10000ECP10
1111111110
